........#..................#..........................................
........#..................#..........................................
........#..................#..........................................
........#..................#..........................................
........#..................#..........................................
........#..................#..........................................
........#..................#..........................................
........#..................#..........................................
........#..................#..........................................
...................#.......#..........................................
#################..#.......#..........................................
...................#..................................................
...................#..................................................
...................#..................................................
...................#....................................#.............
...................#..........###########################.............
...................#...................#..............................
...................#...................#..............................
.......................................#..............................
............#########################..#..............................
.......................................#..............................
.......................................#..............................
.......................................#..............................
.......................................#.........................#....
.......................................#.........................#....
.......................................#.........................#....
.................................................................#....
...................................###############################....
......................................................................
......................................................................
