...#.......
...#.......
...#...#...
.......#...
.......#...
